#######################
#S        ######    ###
#         ######    ###
#         ######    ###
#                   ###
#  ###  #### ###### ###
#  ###  #### ###### ###
#  ###       ###### ###
#  ###  #### ###### ###
#       #### ###### ###
#  ## ######        ###
#  ## ###### ###### ###
#  ## ######        ###
#  ## ###### ###### ###
#  ## ###### ###### ###
##### ###### ###### ###
#  ## ###### ###### ###
#  ##     ## ###### ###
#  #####  ## ###### ###
########  ##        ###
#  #####  #############
#  #####           E###
#######################
